"aG" = (/obj/effect/decal/cleanable/dirt,/turf/open/floor/plasteel,/area/shuttle/escape)
"bQ" = (/obj/structure/table,/obj/item/restraints/handcuffs{pixel_y = 3},/turf/open/floor/mineral/plastitanium/red/brig,/area/shuttle/escape)
"dP" = (/obj/structure/closet/crate/medical,/obj/item/storage/firstaid/regular,/obj/item/storage/firstaid/o2{pixel_x = 3; pixel_y = 3},/obj/item/storage/firstaid/toxin{pixel_x = -4; pixel_y = 3},/obj/item/healthanalyzer{pixel_x = 3; pixel_y = 3},/obj/item/lazarus_injector,/mob/living/simple_animal/bot/medbot{name = "\improper emergency medibot"; pixel_x = -3; pixel_y = 2},/obj/effect/turf_decal/stripes/line{dir = 4},/obj/effect/decal/cleanable/dirt,/obj/machinery/light{dir = 8},/obj/effect/turf_decal/bot,/turf/open/floor/plasteel,/area/shuttle/escape)
"eH" = (/obj/structure/table,/obj/item/phone{pixel_x = -3; pixel_y = 3},/obj/machinery/light{dir = 1},/turf/open/floor/mineral/titanium/blue,/area/shuttle/escape)
"fc" = (/obj/structure/chair,/obj/machinery/light/small{dir = 1},/turf/open/floor/mineral/plastitanium/red/brig,/area/shuttle/escape)
"fl" = (/obj/structure/table/optable,/obj/item/surgical_drapes,/obj/machinery/light{dir = 1},/turf/open/floor/mineral/titanium,/area/shuttle/escape)
"fR" = (/obj/machinery/computer/crew{dir = 8},/turf/open/floor/mineral/titanium/blue,/area/shuttle/escape)
"fW" = (/obj/structure/bed/roller,/turf/open/floor/mineral/titanium,/area/shuttle/escape)
"hM" = (/obj/structure/table,/obj/item/book/manual/wiki/security_space_law{pixel_x = -4; pixel_y = 4},/obj/item/folder/red{pixel_x = 3},/turf/open/floor/mineral/plastitanium/red/brig,/area/shuttle/escape)
"hO" = (/obj/structure/table,/obj/item/restraints/handcuffs{pixel_y = 3},/turf/open/floor/mineral/titanium/blue,/area/shuttle/escape)
"ib" = (/obj/structure/closet/emcloset,/turf/open/floor/mineral/titanium/blue,/area/shuttle/escape)
"is" = (/obj/effect/decal/cleanable/dirt,/obj/structure/chair,/turf/open/floor/plasteel,/area/shuttle/escape)
"iD" = (/obj/structure/table,/obj/item/storage/toolbox/emergency{pixel_y = 3},/turf/open/floor/mineral/titanium/blue,/area/shuttle/escape)
"jg" = (/obj/effect/turf_decal/stripes/line{dir = 4},/obj/effect/decal/cleanable/dirt,/obj/effect/turf_decal/bot,/turf/open/floor/plasteel,/area/shuttle/escape)
"jC" = (/obj/structure/table,/obj/item/storage/firstaid,/turf/open/floor/mineral/titanium/blue,/area/shuttle/escape)
"jU" = (/obj/effect/decal/cleanable/dirt,/obj/effect/decal/cleanable/dirt,/obj/machinery/door/airlock/external{name = "Emergency Recovery Airlock"},/turf/open/floor/plasteel,/area/shuttle/escape)
"kk" = (/obj/structure/table,/turf/open/floor/mineral/titanium/blue,/area/shuttle/escape)
"ku" = (/obj/structure/sign/departments/medbay/alt,/turf/closed/wall/mineral/titanium,/area/shuttle/escape)
"kW" = (/obj/structure/chair{dir = 8},/turf/open/floor/mineral/titanium/blue,/area/shuttle/escape)
"lm" = (/obj/machinery/sleeper{dir = 8},/turf/open/floor/mineral/titanium,/area/shuttle/escape)
"lq" = (/obj/machinery/door/airlock/security/glass{name = "Brig"; req_access_txt = "2"},/turf/open/floor/mineral/plastitanium/red/brig,/area/shuttle/escape)
"lT" = (/obj/machinery/door/airlock/titanium{name = "Emergency Shuttle Airlock"},/turf/open/floor/plasteel,/area/shuttle/escape)
"me" = (/obj/machinery/portable_atmospherics/canister/oxygen,/obj/effect/turf_decal/stripes/line{dir = 4},/obj/effect/decal/cleanable/dirt,/obj/effect/turf_decal/bot,/turf/open/floor/plasteel,/area/shuttle/escape)
"mH" = (/obj/structure/tank_dispenser/oxygen{layer = 2.7; pixel_x = -1; pixel_y = 2},/turf/open/floor/mineral/titanium/blue,/area/shuttle/escape)
"nr" = (/obj/machinery/computer/security{dir = 8},/turf/open/floor/mineral/titanium/blue,/area/shuttle/escape)
"ox" = (/turf/open/floor/plasteel,/area/shuttle/escape)
"qo" = (/obj/machinery/door/airlock/command/glass{name = "Cockpit"; req_access_txt = "19"},/turf/open/floor/mineral/titanium,/area/shuttle/escape)
"rm" = (/obj/structure/chair{dir = 8},/obj/machinery/light{dir = 4},/turf/open/floor/mineral/titanium/blue,/area/shuttle/escape)
"rv" = (/turf/open/floor/mineral/titanium/white,/area/shuttle/escape)
"se" = (/obj/machinery/vending/wallmed{name = "Emergency NanoMed"; use_power = 0},/turf/closed/wall/mineral/titanium,/area/shuttle/escape)
"sJ" = (/obj/structure/table,/obj/machinery/recharger{active_power_usage = 0; idle_power_usage = 0; use_power = 0},/turf/open/floor/mineral/plastitanium/red/brig,/area/shuttle/escape)
"tG" = (/turf/open/floor/mineral/titanium/blue,/area/shuttle/escape)
"tS" = (/obj/effect/turf_decal/stripes/line{dir = 8},/obj/effect/decal/cleanable/dirt,/obj/structure/extinguisher_cabinet{pixel_x = 32},/obj/effect/turf_decal/delivery,/turf/open/floor/plasteel,/area/shuttle/escape)
"uf" = (/obj/effect/turf_decal/stripes/line,/turf/open/floor/plasteel,/area/shuttle/escape)
"un" = (/obj/structure/shuttle/engine/propulsion,/turf/open/floor/plating,/area/shuttle/escape)
"vb" = (/obj/structure/rack,/obj/item/storage/toolbox/electrical{pixel_x = -3; pixel_y = 1},/obj/item/storage/toolbox/mechanical{pixel_y = -1},/obj/item/storage/toolbox/emergency{pixel_x = 3; pixel_y = -5},/obj/effect/decal/cleanable/dirt,/obj/effect/turf_decal/stripes/line,/obj/machinery/light{dir = 1},/turf/open/floor/plasteel,/area/shuttle/escape)
"vM" = (/obj/structure/rack,/obj/item/crowbar,/obj/item/wrench,/obj/item/weldingtool,/obj/item/wirecutters,/obj/item/stack/cable_coil,/obj/effect/decal/cleanable/dirt,/obj/effect/turf_decal/stripes/corner{dir = 8},/turf/open/floor/plasteel,/area/shuttle/escape)
"wS" = (/obj/machinery/door/airlock/command{name = "Emergency Recovery Airlock"; req_access_txt = "19"},/obj/effect/decal/cleanable/dirt,/turf/open/floor/plasteel,/area/shuttle/escape)
"wZ" = (/obj/structure/table,/obj/item/storage/box/donkpockets,/turf/open/floor/mineral/titanium/blue,/area/shuttle/escape)
"yB" = (/obj/effect/decal/cleanable/dirt,/obj/effect/turf_decal/delivery,/obj/effect/turf_decal/stripes/corner{dir = 1},/turf/open/floor/plasteel,/area/shuttle/escape)
"zr" = (/obj/effect/turf_decal/delivery,/obj/effect/turf_decal/stripes/line{dir = 8},/turf/open/floor/plasteel,/area/shuttle/escape)
"zV" = (/obj/machinery/light{dir = 2},/turf/open/floor/mineral/titanium/blue,/area/shuttle/escape)
"zX" = (/obj/machinery/light{dir = 4},/turf/open/floor/mineral/titanium/blue,/area/shuttle/escape)
"AS" = (/obj/machinery/computer/station_alert,/turf/open/floor/mineral/titanium/blue,/area/shuttle/escape)
"BZ" = (/obj/structure/table,/obj/machinery/recharger{active_power_usage = 0; idle_power_usage = 0; pixel_y = 4; use_power = 0},/obj/machinery/light/small{brightness = 3; dir = 8},/turf/open/floor/mineral/titanium/blue,/area/shuttle/escape)
"Dq" = (/obj/effect/decal/cleanable/dirt,/obj/effect/decal/cleanable/dirt,/obj/machinery/door/airlock/external{name = "Emergency Recovery Airlock"},/obj/machinery/door/airlock/external{name = "Emergency Recovery Airlock"},/turf/open/floor/plasteel,/area/shuttle/escape)
"DY" = (/obj/effect/spawner/structure/window/shuttle,/turf/open/floor/plating,/area/shuttle/escape)
"Fy" = (/obj/structure/table,/obj/item/clipboard,/obj/item/folder/yellow,/obj/item/pen,/obj/item/hand_labeler_refill,/obj/effect/decal/cleanable/dirt,/obj/effect/turf_decal/stripes/corner,/obj/effect/decal/cleanable/dirt,/turf/open/floor/plasteel,/area/shuttle/escape)
"FI" = (/obj/machinery/status_display/evac,/turf/closed/wall/mineral/titanium,/area/shuttle/escape)
"FM" = (/obj/structure/table,/obj/item/storage/box/handcuffs{pixel_x = 2; pixel_y = 2},/obj/machinery/light/small{brightness = 3; dir = 8},/turf/open/floor/mineral/plastitanium/red/brig,/area/shuttle/escape)
"Gi" = (/obj/effect/decal/cleanable/dirt,/obj/machinery/recharge_station,/obj/effect/turf_decal/stripes/line{dir = 1},/turf/open/floor/plasteel,/area/shuttle/escape)
"Gv" = (/obj/effect/decal/cleanable/dirt,/obj/machinery/suit_storage_unit/standard_unit,/turf/open/floor/plasteel,/area/shuttle/escape)
"GE" = (/obj/structure/chair,/turf/open/floor/mineral/plastitanium/red/brig,/area/shuttle/escape)
"Hz" = (/obj/structure/table,/obj/item/storage/fancy/donut_box,/turf/open/floor/mineral/titanium/blue,/area/shuttle/escape)
"IZ" = (/obj/machinery/door/airlock/medical/glass{name = "Escape Shuttle Infirmary"},/turf/open/floor/mineral/titanium/white,/area/shuttle/escape)
"JL" = (/obj/item/radio/intercom{name = "Station Intercom (General)"; pixel_y = -31},/turf/open/floor/mineral/plastitanium/red/brig,/area/shuttle/escape)
"JU" = (/turf/open/floor/mineral/titanium,/area/shuttle/escape)
"Kc" = (/obj/structure/extinguisher_cabinet{pixel_x = 32},/turf/open/floor/mineral/titanium/blue,/area/shuttle/escape)
"Kh" = (/obj/structure/table,/obj/item/paper_bin{pixel_x = -2; pixel_y = 8},/obj/item/folder/blue,/obj/item/pen/fountain,/turf/open/floor/mineral/titanium/blue,/area/shuttle/escape)
"KF" = (/turf/closed/wall/mineral/titanium,/area/shuttle/escape)
"KY" = (/obj/machinery/computer/emergency_shuttle,/turf/open/floor/mineral/titanium/blue,/area/shuttle/escape)
"Lt" = (/obj/effect/decal/cleanable/dirt,/obj/machinery/light{dir = 2},/turf/open/floor/plasteel,/area/shuttle/escape)
"LP" = (/obj/effect/turf_decal/delivery,/obj/effect/turf_decal/stripes/line{dir = 1},/turf/open/floor/plasteel,/area/shuttle/escape)
"LT" = (/obj/structure/table,/turf/open/floor/mineral/titanium,/area/shuttle/escape)
"MN" = (/obj/structure/extinguisher_cabinet,/turf/closed/wall/mineral/titanium,/area/shuttle/escape)
"MV" = (/obj/structure/table,/obj/effect/turf_decal/stripes/corner{dir = 4},/obj/effect/decal/cleanable/dirt,/turf/open/floor/plasteel,/area/shuttle/escape)
"Nf" = (/obj/structure/table,/obj/item/reagent_containers/glass/bottle/epinephrine{pixel_x = 6},/obj/item/reagent_containers/glass/bottle/charcoal{pixel_x = -3},/obj/item/reagent_containers/glass/bottle/epinephrine{pixel_x = -3; pixel_y = 8},/obj/item/reagent_containers/glass/bottle/charcoal{pixel_x = 6; pixel_y = 8},/obj/item/reagent_containers/syringe/epinephrine{pixel_x = 3; pixel_y = -2},/obj/item/reagent_containers/syringe/epinephrine{pixel_x = 4; pixel_y = 1},/obj/item/reagent_containers/syringe/epinephrine{pixel_x = -2; pixel_y = 5},/obj/item/reagent_containers/syringe/epinephrine{pixel_x = 2; pixel_y = 8},/turf/open/floor/mineral/titanium,/area/shuttle/escape)
"NG" = (/obj/item/clothing/suit/hazardvest{desc = "A high-visibility lifejacket complete with whistle and slot for oxygen tanks."; name = "emergency lifejacket"},/obj/item/clothing/suit/hazardvest{desc = "A high-visibility lifejacket complete with whistle and slot for oxygen tanks."; name = "emergency lifejacket"},/obj/item/clothing/suit/hazardvest{desc = "A high-visibility lifejacket complete with whistle and slot for oxygen tanks."; name = "emergency lifejacket"},/obj/item/clothing/suit/hazardvest{desc = "A high-visibility lifejacket complete with whistle and slot for oxygen tanks."; name = "emergency lifejacket"},/obj/item/clothing/suit/hazardvest{desc = "A high-visibility lifejacket complete with whistle and slot for oxygen tanks."; name = "emergency lifejacket"},/obj/item/tank/internals/emergency_oxygen{pixel_x = 3},/obj/item/tank/internals/emergency_oxygen{pixel_x = 3},/obj/item/tank/internals/emergency_oxygen{pixel_x = 3},/obj/item/tank/internals/emergency_oxygen{pixel_x = 3},/obj/item/tank/internals/emergency_oxygen{pixel_x = 3},/obj/item/clothing/mask/breath{pixel_x = -3; pixel_y = -3},/obj/item/clothing/mask/breath{pixel_x = -3; pixel_y = -3},/obj/item/clothing/mask/breath{pixel_x = -3; pixel_y = -3},/obj/item/clothing/mask/breath{pixel_x = -3; pixel_y = -3},/obj/item/clothing/mask/breath{pixel_x = -3; pixel_y = -3},/obj/item/clothing/head/hardhat/orange{name = "protective hat"; pixel_y = 9},/obj/item/clothing/head/hardhat/orange{name = "protective hat"; pixel_y = 9},/obj/item/clothing/head/hardhat/orange{name = "protective hat"; pixel_y = 9},/obj/item/clothing/head/hardhat/orange{name = "protective hat"; pixel_y = 9},/obj/item/clothing/head/hardhat/orange{name = "protective hat"; pixel_y = 9},/obj/structure/closet/crate{name = "lifejackets"},/turf/open/floor/mineral/titanium/blue,/area/shuttle/escape)
"NQ" = (/obj/structure/chair/office{dir = 8},/turf/open/floor/mineral/titanium/blue,/area/shuttle/escape)
"NT" = (/obj/structure/rack,/obj/item/tank/internals/oxygen/red,/obj/item/clothing/suit/fire/firefighter,/obj/item/clothing/mask/gas,/obj/item/clothing/head/hardhat/red,/obj/effect/decal/cleanable/dirt,/obj/effect/turf_decal/stripes/line{dir = 4},/obj/effect/turf_decal/bot,/turf/open/floor/plasteel,/area/shuttle/escape)
"OL" = (/obj/structure/table,/obj/item/defibrillator/loaded,/obj/machinery/light{dir = 1},/turf/open/floor/mineral/titanium,/area/shuttle/escape)
"OP" = (/obj/structure/sink{dir = 8; pixel_x = -12},/turf/open/floor/mineral/titanium,/area/shuttle/escape)
"PX" = (/obj/effect/decal/cleanable/dirt,/obj/machinery/door/airlock/external{name = "Emergency Recovery Airlock"},/turf/open/floor/plasteel,/area/shuttle/escape)
"Qa" = (/obj/structure/chair{dir = 8},/turf/open/floor/mineral/plastitanium/red/brig,/area/shuttle/escape)
"Qu" = (/obj/structure/chair/office{dir = 4},/turf/open/floor/mineral/titanium/blue,/area/shuttle/escape)
"Qx" = (/obj/structure/table,/obj/machinery/microwave,/turf/open/floor/mineral/titanium/blue,/area/shuttle/escape)
"QG" = (/obj/machinery/space_heater,/obj/effect/turf_decal/stripes/line{dir = 4},/obj/effect/decal/cleanable/dirt,/obj/effect/turf_decal/bot,/turf/open/floor/plasteel,/area/shuttle/escape)
"QW" = (/obj/machinery/computer/communications,/turf/open/floor/mineral/titanium/blue,/area/shuttle/escape)
"Ra" = (/obj/structure/reagent_dispensers/fueltank,/obj/effect/turf_decal/stripes/line{dir = 8},/obj/effect/decal/cleanable/dirt,/turf/open/floor/plasteel,/area/shuttle/escape)
"Rs" = (/obj/structure/chair{dir = 4},/turf/open/floor/mineral/titanium/blue,/area/shuttle/escape)
"Sk" = (/obj/structure/chair/office{dir = 1},/turf/open/floor/mineral/titanium/blue,/area/shuttle/escape)
"SN" = (/obj/structure/chair{dir = 4},/obj/machinery/light{dir = 8},/turf/open/floor/mineral/titanium/blue,/area/shuttle/escape)
"Tp" = (/turf/template_noop,/area/template_noop)
"UD" = (/obj/machinery/door/airlock/medical/glass{name = "Escape Shuttle Infirmary"},/turf/open/floor/plasteel,/area/shuttle/escape)
"UN" = (/obj/structure/reagent_dispensers/watertank,/obj/effect/turf_decal/stripes/line{dir = 8},/obj/effect/decal/cleanable/dirt,/turf/open/floor/plasteel,/area/shuttle/escape)
"VN" = (/obj/effect/decal/cleanable/dirt,/obj/machinery/light/small{dir = 8},/turf/open/floor/plasteel,/area/shuttle/escape)
"Wd" = (/obj/effect/decal/cleanable/dirt,/obj/structure/reagent_dispensers/watertank,/turf/open/floor/plasteel,/area/shuttle/escape)
"XH" = (/obj/structure/table,/obj/item/scalpel{pixel_y = 12},/obj/item/circular_saw,/obj/item/retractor{pixel_x = 4},/obj/item/hemostat{pixel_x = -4},/obj/item/clothing/gloves/color/latex,/obj/item/clothing/mask/surgical,/obj/item/surgicaldrill,/obj/item/cautery,/turf/open/floor/mineral/titanium,/area/shuttle/escape)
"XM" = (/obj/structure/extinguisher_cabinet{pixel_y = -32},/turf/open/floor/mineral/titanium,/area/shuttle/escape)
"YQ" = (/obj/structure/window/reinforced{dir = 1},/obj/structure/shuttle/engine/heater,/turf/open/floor/plating,/area/shuttle/escape)
"Zn" = (/turf/open/floor/mineral/plastitanium/red/brig,/area/shuttle/escape)

(1,1,1) = {"
KFKFKFKFKFKFDYDYDYDYDYKFKFKF
DYWdisisisKFiDASKYQWHzeHjCKF
DqaGaGLtaGKFBZtGSktGtGSkfRKF
jUaGaGKFPXKFKhNQJUJUJUQunrKF
DYGvGvKFVNwStGzVXMJULThOkkKF
KFKFKFKFKFKFKFFIKFqoKFKFKFKF
KFhMGEfcGEKFtGtGtGJUibibibKF
KFbQZnZnZnlqtGJUJUJUJUJUzXKF
KFFMZnZnQaDYRsJUkWDYRsJUkWDY
KFsJJLZnQaFIRsJUkWDYRsJUkWDY
KFKFKFKFKFKFSNJUkWMNRsJUrmKF
KFNfflXHOLDYRsJUkWDYRsJUkWDY
DYLTrvrvrvIZtGJUkWDYRsJUkWDY
DYOPrvrvlmDYtGJUJUJUJUJUzXKF
KFfWrvrvlmkutGJUtGtGtGJUKcKF
KFKFUDKFKFKFRsJUkWDYRsJUkWDY
KFFyufvbvMKFSNJUkWDYRsJUkWDY
KFjgaGoxUNFIRsJUkWseRsJUrmFI
DYNToxoxRaDYRsJUkWDYRsJUkWDY
DYQGoxaGtSKFSNJUkWDYRsJUkWDY
KFdPaGoxzrlTtGtGtGtGtGtGKFKF
KFmeoxaGzrlTtGQxwZmHNGkkKFTp
KFMVGiLPyBKFYQYQYQYQYQYQKFTp
KFKFKFlTlTKFununununununKFTp
"}
